#################
#  H    HH   @  #
# #H# # #H# # # #
# H  C   HC  @  #
# # # # #H# # # #
#HC@ IHHHHH   @ #
# # # # # #H# # #
#HHHhHH  HC HHHH#
# # # # #H# # # #
# @ C H HH  @   #
# # # #H#H# # # #
#C    H  H  C @ #
#################
